016 017 017 017 017 017 017 017 017 017 017 017 017 017 017 018
031 071 032 032 032 032 032 032 032 032 032 032 032 032 070 033
031 032 032 032 032 032 032 351 361 032 032 032 032 032 032 033
031 032 032 032 032 032 032 501 511 032 329 032 032 032 032 033
031 032 032 032 032 032 381 531 381 241 329 032 032 032 032 033
031 032 032 381 351 361 391 251 261 231 351 361 391 032 032 033
031 032 032 231 501 511 381 401 411 231 501 511 381 032 032 033
031 032 032 032 032 032 231 841 391 391 032 032 032 032 032 033
031 032 032 032 032 032 032 351 361 032 032 032 032 032 032 033
031 032 032 032 032 032 032 501 511 032 032 032 032 032 032 033
031 056 032 032 032 032 032 032 032 032 032 032 032 032 055 033
046 047 047 047 047 047 047 047 047 047 047 047 047 047 047 048