016 017 017 017 017 017 017 017 017 017 017 017 017 017 017 018
031 025 026 054 083 099 032 083 032 054 145 160 160 025 026 033
031 040 041 096 032 087 032 027 032 054 032 145 032 040 041 033
031 145 160 032 042 032 032 032 083 032 027 032 054 027 032 033
031 032 054 083 032 160 016 017 017 018 032 083 032 032 100 033
031 028 032 032 027 160 031 551 561 033 027 032 032 099 032 033
031 032 032 027 032 054 031 701 711 033 160 068 032 054 100 033
031 027 087 032 101 054 046 047 047 048 145 145 032 042 032 033
031 027 032 099 032 101 068 032 032 042 032 087 032 032 027 033
031 025 026 054 032 160 032 032 054 032 032 032 101 025 026 033
031 040 041 054 160 145 083 032 032 027 032 054 032 040 041 033
046 047 047 047 047 047 047 047 047 047 047 047 047 047 047 048