016 017 017 017 017 017 017 017 017 017 017 017 017 017 017 018
031 032 032 032 032 032 032 032 032 032 032 032 032 032 032 033
031 032 032 032 032 032 032 032 032 032 032 032 032 032 032 033
031 032 032 032 032 032 032 032 032 032 032 032 032 032 032 033
031 032 032 032 032 032 032 032 032 032 032 032 032 032 032 033
031 032 032 032 032 032 032 032 032 032 032 032 032 032 032 033
031 032 032 032 032 032 032 032 032 032 032 032 032 032 032 033
031 032 032 032 032 032 032 032 032 032 032 032 032 032 032 033
031 032 032 032 032 032 032 032 032 032 032 032 032 032 032 033
031 032 032 032 032 032 032 032 032 032 032 032 032 032 032 033
031 032 032 032 032 032 032 032 032 032 032 032 032 032 032 033
046 047 047 047 047 047 047 047 047 047 047 047 047 047 047 048