016 017 017 017 017 017 017 017 017 017 017 017 017 017 017 018
031 145 329 160 032 027 032 028 068 032 032 032 043 032 042 033 
031 160 068 032 027 032 032 032 032 028 032 098 032 100 032 033 
031 043 032 027 032 032 329 096 100 329 032 117 043 098 032 033 
031 043 032 068 032 329 115 072 032 097 329 032 098 097 032 033 
031 032 117 068 117 329 032 055 056 096 329 032 096 032 072 033 
031 032 032 032 032 329 097 070 071 115 329 032 032 117 032 033 
031 032 115 032 160 329 096 042 032 072 329 032 098 068 032 033 
031 098 100 043 032 145 329 032 032 329 032 100 032 032 115 033
031 032 097 117 032 032 032 032 096 032 027 032 032 160 032 033 
031 043 032 032 115 032 027 032 032 097 032 032 117 145 160 033 
046 047 047 047 047 047 047 047 047 047 047 047 047 047 047 048
