2 3 3 3 3 3 3 3 3 3 3 3 3 3 3 4
9 1 1 1 1 1 1 1 1 1 1 1 1 1 1 5
9 1 1 1 1 1 1 1 1 1 1 1 1 1 1 10
9 1 1 1 1 1 1 1 1 1 1 1 1 1 1 10
9 1 1 1 1 1 1 1 1 1 1 1 1 1 1 10
9 1 1 1 1 1 1 1 1 1 1 1 1 1 1 1
9 1 1 1 1 1 1 10 10 1 1 1 1 1 1 1
9 1 1 1 1 1 1 1 1 1 1 1 1 1 1 10
9 1 1 1 1 1 1 1 1 1 1 1 1 1 1 10
9 1 1 1 1 1 1 1 1 1 1 1 1 1 1 10
9 1 1 1 1 1 1 1 1 1 1 1 1 1 1 5
8 7 7 7 7 7 7 7 7 7 7 7 7 7 7 6