016 017 017 017 017 017 017 017 017 017 017 017 017 017 017 018
031 041 087 032 053 083 024 027 032 027 032 043 032 042 040 033
031 032 087 032 032 032 053 043 087 032 027 032 032 043 043 033
031 087 087 076 078 098 101 032 038 054 032 076 078 043 038 033
031 087 039 106 108 087 083 032 038 038 083 106 108 083 054 033
031 039 069 032 087 032 087 087 032 053 054 043 087 038 032 033
031 039 087 032 032 032 032 087 115 032 043 032 043 054 032 033
031 053 039 076 078 111 038 032 032 098 032 076 078 032 115 033
031 087 053 106 108 039 054 032 038 024 042 106 108 032 032 033
031 087 087 032 023 054 032 032 087 038 039 038 032 087 032 033
031 026 032 032 068 032 098 087 032 032 027 054 087 032 025 033
046 047 047 047 047 047 047 047 047 047 047 047 047 047 047 048
