0 0 0 0 0 0 0 0 0 0 0 0 0 0 0 0
0 2 3 3 3 3 3 3 3 3 3 3 3 3 4 0
0 9 1 1 1 1 1 1 1 1 1 1 1 1 5 0
0 9 1 1 1 1 1 1 1 1 1 1 1 1 10 0
0 9 1 1 1 1 1 1 1 1 1 1 1 1 10 0
0 9 1 1 1 1 1 1 1 1 1 1 1 1 1 0
0 9 1 1 1 1 1 1 1 1 1 1 1 1 1 0
0 9 1 1 1 1 1 1 1 1 1 1 1 1 10 0
0 9 1 1 1 1 1 1 1 1 1 1 1 1 10 0
0 9 1 1 1 1 1 1 1 1 1 1 1 1 5 0
0 8 7 7 7 7 7 7 7 7 7 7 7 7 6 0
0 0 0 0 0 0 0 0 0 0 0 0 0 0 0 0