2 3 3 3 3 3 3 3 3 3 3 3 3 3 3 4
9 1 1 1 1 21 1 1 1 1 19 1 1 1 1 5
9 1 1 18 1 1 1 1 1 1 1 1 1 1 1 10
9 1 1 1 1 1 1 1 1 1 1 1 19 1 1 10
9 1 1 1 19 1 1 1 21 1 1 1 1 1 1 10
9 1 21 1 1 1 2 3 4 1 1 1 19 1 1 1
9 1 1 1 1 1 8 7 6 1 1 1 1 1 1 1
9 1 18 1 1 1 1 1 1 1 1 1 1 1 1 10
9 1 1 1 1 1 1 1 1 19 1 1 1 18 1 10
9 1 1 1 1 18 1 1 1 1 1 1 1 1 1 10
9 1 20 1 1 1 1 1 1 1 1 1 20 1 1 5
8 7 7 7 7 7 7 7 7 7 7 7 7 7 7 6